11111111
11EE000000011
1111000000111
1111111111111
