11111111111111
11100000000111
1100000P110001
11000000000111
11111111111111
