111111
100001
10P0
100EC1
111111
