111111111111
110000P00011
1000E0000111
1110C0001111
110000001111
