111111111111111111111111111111111111111111
100000000000P00000000000C000000000000000E1
100000000000000000000000000000000000000001
100000000000000000000011111000000000000001
100000000000000000001110000000000000000001
100000000000000000010000000000000000000001
100000000000000000010000000000000000000001
100000000000000000010000000000000000000001
100000000000000000010000000000000000000001
100000000000000000000000000000000000000001
100000000000000000000000000000000000000001
100000000000000000000000000000001111000001
111111000000000000000000000000000000000001
100000000001111110000000001000000000000001
100000000001110000000000001000000000000001
100000000000000000000000001000000000000001
100000000000000000000001111000000000000001
100000000000000000000000000000000000000001
100000000000000000000000000000000000000001
100000000000000000000000000000000000000001
100000000000000000000000000000000000000001
100000000000000000000000000000000000000001
111111111111111111111111111111111111111111
